{
  "wK": 0,
  "wQ": 1,
  "wR": 2,
  "wB": 3,
  "wN": 4,
  "wP": 5,
  "bK": 6,
  "bQ": 7,
  "bR": 8,
  "bB": 9,
  "bN": 10,
  "bP": 11
}