{
  "Empty": 0,
  "wK": 1,
  "wQ": 2,
  "wR": 3,
  "wB": 4,
  "wN": 5,
  "wP": 6,
  "bK": 7,
  "bQ": 8,
  "bR": 9,
  "bB": 10,
  "bN": 11,
  "bP": 12
}